#################
#...............#
#.######.######.#
#..#w.......w#..#
##.#..##.##..#.##
#..#.........#..#
#.######.######.#
#..#.........#..#
##.#..##.##..#.##
#..#.........#..#
#.######.######.#
#..#.........#..#
##.#..##.##..#.##
#..#w.......w#..#
#.######.######.#
#...............#
#################